#######x########
#..............#
#...@....##....#
#........#.....#
#........#.....#
#....#####.....#
#..  ..........#
x..  ...  .....x
#.......   ....#
#.......   ....#
#.......   ....#
#...K...   ....#
#......... ....#
#..............#
#..............#
#######x########
