#######x########
#..  ....K.....#
#...   ..##....#
#....    #.....#
#........#.....#
#........#####.#
#..  ..........#
x..  ..........x
#...     #######
#......  ......#
#.......  .....#
#...@...  .....#
#.             #
#.    ...      #
#.......#      #
#######x########
