################
#@.     ...    #
#..  ......    #
#.   ...       #
#.   ..        #
#.  ...        #
#.   ..        #
#.........    .Q
#   ........  .#
#.    .       .#
#.    .       .#
#.    ....    .#
#.........    .#
#..........   .#
#     .........#
################
